20 15
0 0 0 0 0 0 0 0 0 0 0 0 0 0 0 0 0 0 0 0
0 0 0 0 0 0 0 0 0 0 0 0 0 2 2 2 2 2 2 5
0 0 0 0 0 0 0 0 0 0 0 0 0 1 0 0 0 0 0 0
0 0 2 2 2 2 2 2 3 0 0 0 0 1 0 0 0 0 0 0
0 0 1 0 0 0 0 0 3 0 0 0 0 1 0 0 0 0 0 0
0 0 1 0 0 0 0 0 3 0 0 0 0 1 0 0 0 0 0 0
0 0 1 0 0 0 0 0 3 0 0 0 0 1 0 0 0 0 0 0
0 0 1 0 0 0 0 0 3 0 0 0 0 1 0 0 0 0 0 0
0 0 1 0 0 0 0 0 3 0 0 0 0 1 0 0 0 0 0 0
0 0 1 0 0 0 0 0 3 0 0 0 0 1 0 0 0 0 0 0
0 0 1 0 0 0 0 0 3 0 0 0 0 1 0 0 0 0 0 0
0 0 1 0 0 0 0 0 3 0 0 0 0 1 0 0 0 0 0 0
0 0 1 0 0 0 0 0 3 0 0 0 0 1 0 0 0 0 0 0
0 0 1 0 0 0 0 0 3 0 0 0 0 1 0 0 0 0 0 0
0 0 1 0 0 0 0 0 2 2 2 2 2 1 0 0 0 0 0 0
2 14
6
3 1 1 1 2 2
7
3 3 3 1 1 2 2
8
4 3 3 3 1 1 2 2 2
8
4 4 3 3 2 2 2 2 2
8
4 4 4 3 2 2 2 2 2