20 15
9 9 9 9 9 9 9 9 9 9 9 9 9 9 9 9 9 9 9 9
9 9 9 9 9 0 9 9 9 9 9 9 9 9 9 9 9 9 9 9
9 9 9 9 9 9 9 9 9 9 9 9 9 9 9 9 9 9 9 9
9 9 2 2 2 2 2 2 3 9 9 9 9 9 9 9 9 9 9 9
9 9 1 9 9 9 9 9 3 9 9 9 9 9 9 9 9 9 9 9
9 9 1 9 9 9 9 9 3 9 9 9 9 9 9 0 9 9 9 9
9 9 1 9 9 9 9 9 3 9 9 9 9 9 9 9 9 9 9 9
9 9 1 9 0 9 9 9 3 9 9 9 9 2 2 2 2 2 2 5
9 9 1 9 9 9 9 9 3 9 9 0 9 1 9 9 9 9 9 9
9 9 1 9 9 9 9 9 3 9 9 9 9 1 9 9 9 0 9 9
9 9 1 9 9 9 9 9 3 9 9 9 9 1 9 9 9 9 9 9
9 9 1 9 9 9 9 9 3 9 9 9 9 1 9 9 9 9 9 9
9 9 1 9 9 9 9 9 3 9 0 9 9 1 9 9 9 9 9 9
9 9 1 9 0 9 9 9 3 9 9 9 9 1 9 9 9 9 9 9
9 9 1 9 9 9 9 9 2 2 2 2 2 1 9 9 9 9 9 9
2 14
6
3 1 1 1 2 2
7
3 3 3 1 1 2 2
8
4 3 3 3 1 1 2 2 2
8
4 4 3 3 2 2 2 2 2
8
4 4 4 3 2 2 2 2 2